#Názvy kapitol v Getting Started

Chapter 1 Introducing LibreOffice	Kapitola 1 Predstavujeme LibreOffice
Chapter 2 Setting up LibreOffice	Kapitola 2 Nastavenie LibreOffice
Chapter 3 Using Styles and Templates	Kapitola 3 Používame štýly a šablóny
Chapter 4 Getting Started with Writer	Kapitola 4 Začíname s programom Writer
Chapter 5 Getting Started with Calc	Kapitola 5 Začíname s programom Calc
Chapter 6 Getting Started with Impress	Kapitola 6 Začíname s programom Impress
Chapter 7 Getting Started with Draw	Kapitola 7 Začíname s programom Draw
Chapter 8 Getting Started with Base	Kapitola 8 Začíname s programom Base
Chapter 9 Getting Started with Math	Kapitola 9 Začíname s programom Math
Chapter 10 Printing, Exporting, and E‑mailing	Kapitola 10 Tlač, exportovanie a odosielanie
Chapter 11 Graphics, the Gallery, and Fontwork	Kapitola 11 Grafika, galéria a ozdobné písmo
Chapter 12 Creating Web Pages	Kapitola 12 Vytváranie webových stránok
Chapter 13 Getting Started with Macros	Kapitola 13 Začíname s makrami
Chapter 14 Customizing LibreOffice	Kapitola 14 Prispôsobenie LibreOffice
Appendix A Keyboard Shortcuts	Príloha A Klávesové skratky
Appendix B Open Source, Open Standards, OpenDocument	Príloha B Otvorený softvér, otvorené štandardy a štandard OpenDocument
Getting Started with OpenOffice.org 3.3	Začíname s LibreOffice 4.0
Getting Started with OpenOffice.org 4.0	Začíname s LibreOffice 4.0

Chapter 1, Introducing LibreOffice	Kapitola 1 Predstavujeme LibreOffice
Chapter 2, Setting up LibreOffice	Kapitola 2 Nastavenie LibreOffice
Chapter 3, Using Styles and Templates	Kapitola 3 Používame štýly a šablóny
Chapter 4, Getting Started with Writer	Kapitola 4 Začíname s programom Writer
Chapter 5, Getting Started with Calc	Kapitola 5 Začíname s programom Calc
Chapter 6, Getting Started with Impress	Kapitola 6 Začíname s programom Impress
Chapter 7, Getting Started with Draw	Kapitola 7 Začíname s programom Draw
Chapter 8, Getting Started with Base	Kapitola 8 Začíname s programom Base
Chapter 9, Getting Started with Math	Kapitola 9 Začíname s programom Math
Chapter 10, Printing, Exporting, and E‑mailing	Kapitola 10 Tlač, exportovanie a odosielanie
Chapter 11, Graphics, the Gallery, and Fontwork	Kapitola 11 Grafika, galéria a ozdobné písmo
Chapter 12, Creating Web Pages	Kapitola 12 Vytváranie webových stránok
Chapter 13, Getting Started with Macros	Kapitola 13 Začíname s makrami
Chapter 14, Customizing LibreOffice	Kapitola 14 Prispôsobenie LibreOffice
Appendix A, Keyboard Shortcuts	Príloha A Klávesové skratky
Appendix B, Open Source, Open Standards, OpenDocument	Príloha B Otvorený softvér, otvorené štandardy a štandard OpenDocument

Impress Guide	Návod na používanie programu Impress
Chapter 1 Introducing Impress	Kapitola 1 Ptredstavujeme program Impress
Chapter 2 Using Slide Masters, Styles, and Templates	Kapitola 2 Používanie predlôh snímok, štýlov a šablón
Chapter 3 Adding and Formatting Text	Kapitola 3 pridávanie a formátovanie textu
Chapter 6 Formatting Graphic Objects	Kapitola 6 Formátovanie grafických objektov
Chapter 7 Including Spreadsheets, Charts, and Other Objects.	Kapitola 7 Vkladanie tabuľkových dokumentov, grafov a iných objektov
Chapter 9 Slide Shows	Kapitola 9 Prezentácie
Chapter 10 Printing, E-mailing, Exporting, and Saving Slide Shows Kapitola 10 Tlač, odosielanie, exportovanie a ukladanie prezentácií

Calc Guide	Návod na používanie programu Calc
Chapter 1 Introducing Calc	Kapitola 1 Predstavujeme program Calc
Chapter 2 Entering, Editing and Formatting Data	Kapitola 2 Vkladanie, úprava a formátovanie údajov
Chapter 4 Using Styles and Templates in Calc	Kapitola 4 Používane štýly a šablóny v programe calc
Chapter 6 Printing, Exporting, and E‑mailing	Kapitola 6 Tlač, exportovanie a odosielanie
Chapter 7 Using Formulas and Functions	Kapitola 7 Použivanie vzorcov a funkcií
Chapter 8 Using Pivot Tables	Kapitola 8 Použivanie kontingenčných tabuliek
Chapter 12 Calc Macros	Kapitola 12 Makrá v programe Calc

Writer Guide	Návod na používanie programu Writer
Chapter 3 Working with Text	Kapitola 3 Práca s textom
Chapter 4, Formatting Pages	Kapitola 4 Formátovanie strán
Chapter 5 Printing, Exporting, and E‑mailing	Kapitola 5 Tlač, exportovanie a e-mail
Chapter 6, Introduction to Styles	Kapitola 6 Úvod do štýlov
Chapter 6 Introduction to Styles	Kapitola 6 Úvod do štýlov
Chapter 8, Working with Graphics	Kapitola 8 Práca s grafikou
Chapter 9 Working with Tables	Kapitola 9 Práca s tabuľkami
Chapter 11, Using Mail Merge	Kapitola 11 Používanie hromadnej korešpondencie
Chapter 12, Creating Tables of Contents, Indexes and Bibliographies Kapitola
Chapter 13, Working with Master Documents	Kapitola 13 Práca s hlavnými dokumentami
Chapter 14, Working with Fields	Kapitola 14 Práca s poľami
Chapter 15, Using Forms in Writer	Kapitola 15 Používanie formulárov v programe Write
Chapter 15 Using Forms in Writer	Kapitola 15 Používanie formulárov v programe Write

Draw Guide	Návod na používanie programu Draw
Chapter 1 Introducing Draw	Kapitola 1 Predstavujeme program Draw
Chapter 2 Drawing Basic Shapes	Kapitola 2 Kreslenie základných útvarov
Chapter 3 Working with Objects and Object Points	Kapitola 3 Práca s objektami a bodmi objektov
Chapter 4 Changing Object Attributes	Kapitola 4 Zmena atribútov objektov
Chapter 5 Combining Multiple Objects	Kapitola 5 Kombinovanie viacerých objektov
Chapter 6 Editing Pictures	Kapitola 6 Úprava obrázkov
Chapter 7 Working with 3D Objects	Kapitola 7 Práca s 3D objektami
Chapter 8 Connections, Flowcharts and Organization Charts	Kapitola 8 Spojnice a vývojové a orgamizačné diagramy
Chapter 10 Advanced Draw Techniques	Kapitola 10 Pokročilé techniky na kreslenie

Math Guide	Návod na používanie programu Math
