App info	Informace o aplikaci
Version	Verze
Settings	Nastavení
Template list URL	Adresa seznamu šablon
Keyboard Shortcuts	Klávesové zkratky
General Keyboard Shortcuts	Obecné klávesové zkratky
Undo	Vrátit změny
Ctrl + Z	Ctrl + Z
Redo	Opakovat vrácené
Ctrl + Y	Ctrl + Y
Cut	Vyjmout
Ctrl + X	Ctrl + X
Paste as unformatted text	Vložit jako neformátovaný text
Ctrl + Alt + Shift + V	Ctrl + Alt + Shift + V
Print (Download as PDF)	Tisk (stáhnout jako PDF)
Ctrl + P	Ctrl + P
Display the Keyboard shortcuts help	Zobrazit nápovědu pro klávesové zkratky
Ctrl + Shift + ?	Ctrl + Shift + ?
Text formatting	Formátování textu
Bold	Tučné
Ctrl + B	Ctrl + B
Italic	Kurzíva
Ctrl + I	Ctrl + I
Underline	Podtržené
Ctrl + U	Ctrl + U
Double Underline	Dvojité podtržení
Ctrl + D	Ctrl + D
Strikethrough	Přeškrtnuté
Ctrl + Alt + 5	Ctrl + Alt + 5
Superscript	Horní index
Ctrl + Shift + P	Ctrl + Shift + P
Subscript	Dolní index
Ctrl + Shift + B	Ctrl + Shift + B
Remove direct formatting	Odstranit přímé formátování
Ctrl + M	Ctrl + M
Paragraph formatting	Formátování odstavce
Align Center	Zarovnat na střed
Ctrl + E	Ctrl + E
Align Left	Zarovnat vlevo
Ctrl + L	Ctrl + L
Align Right	Zarovnat vpravo
Ctrl + R	Ctrl + R
Justify	Do bloku
Ctrl + J	Ctrl + J
Apply Default paragraph style	Použít výchozí styl odstavce
Ctrl + 0	Ctrl + 0
Apply Heading 1 paragraph style	Použít styl odstavce Nadpis 1
Ctrl + 1	Ctrl + 1
Apply Heading 2 paragraph style	Použít styl odstavce Nadpis 2
Ctrl + 2	Ctrl + 2
Apply Heading 3 paragraph style	Použít styl odstavce Nadpis 3
Ctrl + 3	Ctrl + 3
Apply Heading 4 paragraph style	Použít styl odstavce Nadpis 4
Ctrl + 4	Ctrl + 4
Apply Heading 5 paragraph style	Použít styl odstavce Nadpis 5
Ctrl + 5	Ctrl + 5
Text selection and navigation in document	Výběr textu a navigace v dokumentu
Select All	Vybrat vše
Ctrl + A	Ctrl + A
Move cursor to the left	Přesunout kurzor doleva
Arrow Left	Šipka vlevo
Move cursor with selection to the left	Přesunout kurzor doleva a vybrat při tom text
Shift + Arrow Left	Shift + šipka vlevo
Go to beginning of a word	Přejít na začátek slova
Ctrl + Arrow Left	Ctrl + šipka vlevo
Select to the left word by word	Vybírat jednotlivá slova směrem vlevo
Ctrl + Shift + Arrow Left	Ctrl + Shift + šipka vlevo
Move cursor to the right	Přesunout kurzor doprava
Arrow Right	Šipka vpravo
Move cursor with selection to the right	Přesunout kurzor doprava a vybrat při tom text
Shift + Arrow Right	Shift + šipka vpravo
Go to start of the next word	Přejít na začátek dalšího slova
Ctrl + Arrow Right	Ctrl + šipka vpravo
Select to the right word by word	Vybírat jednotlivá slova směrem vpravo
Ctrl + Shift + Arrow Right	Ctrl + Shift + šipka vpravo
Move cursor up one line	Přesunout kurzor o jeden řádek nahoru
Arrow Up	Šipka nahoru
Select lines in upwards direction	Vybrat řádky směrem nahoru
Shift + Arrow Up	Shift + šipka nahoru
Move cursor to beginning of the previous paragraph	Přesunout kurzor na začátek předchozího odstavce
Ctrl + Arrow Up	Ctrl + šipka nahoru
Select to beginning of paragraph	Vybrat od začátku odstavce
Ctrl + Shift + Arrow Up	Ctrl + Shift + šipka nahoru
Move cursor down one line	Přesunout kurzor o jeden řádek dolů
Arrow Down	Šipka dolů
Select lines in downwards direction	Vybrat řádky směrem dolů
Shift + Arrow Down	Shift + šipka dolů
Move cursor to beginning of the next paragraph	Přesunout kurzor na začátek následujícího odstavce
Ctrl + Arrow Down	Ctrl + šipka dolů
Select to end of paragraph	Vybrat do konce odstavce
Ctrl + Shift + Arrow Down	Ctrl + Shift + šipka dolů
Go to beginning of line	Přejít na začátek řádku
Home	Home
Go and select to the beginning of a line	Přejít na začátek řádku a vybrat při tom text
Shift + Home	Shift + Home
Go to start of document	Přejít na začátek dokumentu
Ctrl + Home	Ctrl + Home
Go and select text to start of document	Přejít na začátek dokumentu a vybrat při tom text
Ctrl + Shift + Home	Ctrl + Shift + Home
Go to end of line	Přejít na konec řádku
End	End
Go and select to the end of a line	Přejít na konec řádku a vybrat při tom text
Shift + End	Shift + End
Go to end of document	Přejít na konec dokumentu
Ctrl + End	Ctrl + End
Go and select text to end of document	Přejít na konec dokumentu a vybrat při tom text
Ctrl + Shift + End	Ctrl + Shift + End
Move the view up one page	Posunout zobrazení o jednu stránku nahoru
PageUp	PageUp
Switch cursor between text and header	Přepnout kurzor mezi textem a záhlavím
Ctrl + PageUp	Ctrl + PageUp
Extend the selection up one page	Rozšířit výběr o jednu stránku
Shift + PageUp	Shift + PageUp
Move the view down one page	Posunout zobrazení o jednu stránku dolů
PageDown	PageDown
Switch cursor between text and footer	Přepnout kurzor mezi textem a zápatím
Ctrl + PageDown	Ctrl + PageDown
Extend the selection down one page	Rozšířit výběr o jednu stránku dolů
Shift + PageDown	Shift + PageDown
Delete to beginning of word	Smazat od začátku slova
Ctrl + Backspace	Ctrl + Backspace
Delete to end of word	Smazat do konce slova
Ctrl + Del	Ctrl + Del
Delete to beginning of sentence	Smazat od začátku věty
Ctrl + Shift + Backspace	Ctrl + Shift + Backspace
Delete to end of sentence	Smazat do konce věty
Ctrl + Shift + Del	Ctrl + Shift + Del
Shortcut Keys for Tables	Klávesové zkratky pro tabulky
If the active cell is empty: selects the whole table. Otherwise: selects the contents of the active cell. Pressing again selects the entire table.	Je-li aktuální buňka prázdná: vybere celou tabulku. Pokud prázdná není: vybere obsah aktuální buňky. Opětovné stisknutí těchto kláves vybere celou tabulku.
If the active cell is empty: goes to the beginning of the table. Otherwise: first press goes to beginning of the active cell, second press goes to beginning of the current table, third press goes to beginning of document.	Je-li aktuální buňka prázdná: přemístí kurzor na začátek tabulky. Pokud prázdná není: prvním stisknutí těchto kláves přemístí kurzor na začátek aktuální buňky, druhé jej přemístí na začátek aktuální tabulky a třetí jej přemístí na začátek dokumentu.
If the active cell is empty: goes to the end of the table. Otherwise: first press goes to the end of the active cell, second press goes to the end of the current table, third press goes to the end of the document.	Je-li aktuální buňka prázdná: přemístí kurzor na konec tabulky. Pokud prázdná není: prvním stisknutí těchto kláves přemístí kurzor na konec aktuální buňky, druhé jej přemístí na konec aktuální tabulky a třetí jej přemístí na konec dokumentu.
Ctrl + Tab	Ctrl + Tab
Inserts a tab stop (only in tables). Depending on the Window Manager in use, Alt + Tab may be used instead.	Vloží krok tabulátoru (pouze v tabulkách). V závislosti na použití správce oken lze místo této zkratky použít Alt + Tab.
Alt + Arrow Keys	Alt + šipky
Increases/decreases the size of the column/row on the right/bottom cell edge	Zvětší/zmenší velikost sloupce/řádku na pravém/dolním okraji buňky
Alt + Shift + Arrow Keys	Alt + Shift + šipky
Increase/decrease the size of the column/row on the left/top cell edge	Zvětší/zmenší velikost sloupce/řádku na levém/horním okraji buňky
Alt + Ctrl + Arrow Keys	Alt + Ctrl + šipky
Like Alt, but only the active cell is modified	Jako s klávesou Alt, ale změní se pouze aktivní buňka
Ctrl + Alt + Shift + Arrow Keys	Ctrl + Alt + Shift + šipky
Alt + Insert	Alt + Insert
3 seconds in Insert mode, Arrow Key inserts row/column, Ctrl + Arrow Key inserts cell	3 sekundy v režimu vkládání, klávesa šipky vloží řádek/sloupec, Ctrl + klávesa šipky vloží buňku
Alt + Del	Alt + Del
3 seconds in Delete mode, Arrow key deletes row/column, Ctrl + Arrow key merges cell with neighboring cell	3 sekundy v režimu mazání, klávesa šipky smaže řádek/sloupec, Ctrl + klávesa šipky sloučí buňku se sousední buňkou
Shift + Ctrl + Del	Shift + Ctrl + Del
If no whole cell is selected, the text from the cursor to the end of the current sentence is deleted. If the cursor is at the end of a cell, and no whole cell is selected, the contents of the next cell are deleted.	Není-li vybrána celá buňka, smaže se text od kurzoru do konce aktuální věty. Pokud je kurzor na konci buňky a není označena celá buňka, smaže se obsah následující buňky.
If no whole cell is selected and the cursor is at the end of the table, the paragraph following the table will be deleted, unless it is the last paragraph in the document.	Není-li vybrána celá buňka a kurzor je na konci tabulky, smaže se odstavec následující za tabulkou, pokud se nebude jednat o poslední odstavec dokumentu.
If one or more cells are selected, the whole rows containing the selection will be deleted. If all rows are selected completely or partially, the entire table will be deleted.	Pokud je vybrána jedna či více buněk, smaže se celý řádek s danými buňkami. Pokud jsou úplně či částečně vybrány všechny řádky, smaže se celá tabulka.
Word processor functions	Funkce textového editoru
Insert footnote	Vložit poznámku pod čarou
Ctrl + Alt + F	Ctrl + Alt + F
Insert endnote	Vložit vysvětlivku
Ctrl + Alt + D	Ctrl + Alt + D
Insert comment	Vložit komentář
Ctrl + Alt + C	Ctrl + Alt + C
Insert soft hyphen	Vložit volitelné rozdělení
Ctrl + -	Ctrl + -
Insert non-breaking hyphen	Vložit nezlomitelný spojovník
Ctrl + Shift + -	Ctrl + Shift + -
Insert non-breaking space	Vložit nezlomitelnou mezeru
Ctrl + Shift + Space	Ctrl + Shift + Space
Insert line break	Vložit zalomení řádku
Shift + Enter	Shift + Enter
Manual page break	Ruční zalomení stránky
Ctrl + Enter	Ctrl + Enter
Column break (in multicolumnar text)	Zalomení sloupce (v textu s více sloupci)
Ctrl + Shift + Enter	Ctrl + Shift + Enter
Insert new paragraph directly before or after a section, or before a table	Vložit nový odstavec přímo před či za sekci nebo před tabulku
Alt + Enter	Alt + Enter
Insert new paragraph without numbering inside a list. Does not work when the cursor is at the end of the list.	Vložit do seznamu nový odstavec bez číslování. Nefunguje, pokud je kurzor na konci seznamu.
Cell formatting	Formátování buňky
Display comment	Zobrazit komentář
Ctrl + F1	Ctrl + F1
Fill Down	Vyplnit dolů
Set Optimal Column Width	Nastavit optimální šířku sloupce
Two decimal places, thousands separator	Dvě desetinná místa, oddělovač tisíců
Ctrl + Shift + 1	Ctrl + Shift + 1
Standard exponential format	Standardní exponenciální formát
Ctrl + Shift + 2	Ctrl + Shift + 2
Standard date format	Standardní formát data
Ctrl + Shift + 3	Ctrl + Shift + 3
Standard currency format	Standardní formát měny
Ctrl + Shift + 4	Ctrl + Shift + 4
Standard percentage format (two decimal places)	Standardní formát procent (dvě desetinná místa)
Ctrl + Shift + 5	Ctrl + Shift + 5
Standard format	Standardní formát
Ctrl + Shift + 6	Ctrl + Shift + 6
Demote list item (list item has to be selected)	Snížit úroveň položky seznamu (položka musí být vybrána)
Tab	Tab
Promote list item (list item has to be selected)	Zvýšit úroveň položky seznamu (položka musí být vybrána)
Shift + Tab	Shift + Tab
Text selection and navigation in a textbox	Výběr textu a navigace v textovém poli
Go and select text to start of textbox	Přejít na začátek textového pole a vybrat při tom text
Go and select text to end of textbox	Přejít na konec textového pole a vybrat při tom text
Slide / draw page keyboard shortcuts	Klávesové zkratky snímku/kresby
Escape current mode, i.e. from edit mode switch to object selection mode, from object selection mode switch to view mode.	Opustit aktuální režim, tj. z režimu úprav přepnout do režimu výběru objektu, z režimu výběru objektu přepnout do režimu prohlížení.
Esc	Esc
Select objects in the order in which they were created	Vybírat objekty v pořadí, v jakém byly vytvořeny
Select objects in the reverse order in which they were created	Vybírat objekty v opačném pořadí, než v jakém byly vytvořeny
Move to next text object on slide / drawing page	Přesunout se na další textový objekt na snímku/kresbě
Select all in slide / drawing page	Vybrat vše na snímku/kresbě
"<span class=""productname"">%productName</span> Help"	
Collaborative editing	Formátování buňky
"<span class=""productname"">%productName</span> user interface"	
Opening, closing, saving, printing and downloading documents	
Editing documents	
Advanced features	
"<span class=""productname"">%productName</span> spreadsheets"	
Editing spreadsheets	
Formulas	
Formatting spreadsheets	
"<span class=""productname"">%productName</span> text documents"	
Editing text documents	
Context menus	
Advanced text document editor features	
"<span class=""productname"">%productName</span> presentations"	
Editing presentations	
Slide show	
Slide pane	
Frequently Asked Questions	
General	
Text documents	
Spreadsheets	
Presentations	
"<span class=""productname"">%productName</span> allows you to create and edit office documents text documents, spreadsheets and presentations directly in your browser, in a simple and straight-forward way. You can work alone on a document, or collaboratively as part of a team."	
Each user gets assigned a color. The cursor of each user will be shown in the assigned color. Note: you will see your cursor as black, blinking cursor, although others will see you with a different color.	
You can jump to the cursor of a user by clicking on the name (or avatar) of the user. It is possible to follow the editor.	
"<span class=""productname"">%productName</span> notifies you with a small notification in the footer when a new user enters or when a user leaves."	
"<span class=""productname"">%productName</span> uses modern browser resources to adapt the user interface to the size of the viewing area, including small screens found in mobile devices. The interface is composed of:"	
"<span class=""def"">The document area:</span> The application area shows the document contents, either spreadsheets, presentations or text documents."	
"<span class=""def"">The menu bar:</span> The main menu is placed on the top and includes many options, commands for printing, editing, viewing and other advanced commands. You can hide the menu bar clicking on the <img style=""height:0.6cm;width:0.6cm;"" src=""images/fold.svg""> icon on the far right. Click on the <img style=""height:0.6cm;width:0.6cm;"" src=""images/unfold.svg""> icon to show the menu."	
"<span class=""def"">Context menus:</span> On clicking with the right mouse button, a menu appears with commands associated with the underlying object."	
"<span class=""def"">The toolbar:</span> The toolbar contains the most used options for daily editing. Toolbar buttons are dynamic, meaning that their state (on or off) depends on different factors."	
"<span class=""def"">The status bar:</span> The status bar is shown in the bottom, and contains several useful options and features."	
"<span class=""def"">The search bar:</span> Searching starts automatically when content is inserted in the search box, and the document window automatically moves to the first occurrence found. Searching is not case-sensitive. There are three buttons right next to the search box:"	
Search backwards	
Search forward	
Cancel the search (appears only when a text has been searched)	
"<span class=""def"">The zoom bar:</span> At the right of the status bar, there is a set of buttons that allow you to zoom to 100%, zoom out and zoom in. The zoom applies to the document area, the user interface is not affected. The current level of zoom is shown in this area."	
Text, charts, shapes and svg images will stay sharp, when zooming in, you will only see pixels appear at inserted images, such as jpg’s or png’s.	
Using the browser zoom affects the document and user interface areas.	
"<span class=""def"">The information bar:</span> At the right of the search bar, a set of information on the on the document is displayed. The actual information depends on the nature of the document."	
"Your documents are stored and managed in the cloud storage that is integrated with <span class=""productname"">%productName</span>."	
"To download a document download it from the <span class=""productname"">%productName</span> application’s <span class=""ui"">File</span> menu. The download formats available depends on the application. All applications exports documents in PDF format."	
"To open document, click on the file to open the <span class=""productname"">%productName</span> module associated to the document format."	
"Documents in <span class=""productname"">%productName</span> save automatically, but if you are concerned that a document is synchronized as quickly as possible you can also force saving using the <span class=""ui"">File</span> menu’s <span class=""ui"">Save</span> entry."	
Depending on the capabilities of your browser the print window may appear or a “Download PDF export?” popup shows. You can print this PDF in your favorite PDF reader.	
When closing a document, it is automatically saved if it has been changed.	
Document editing should be familiar to everyone that has used an office application before, but here are some distinctive features:	
Copy and Paste	
"Rich content copy/cut and paste is supported, not only within a given document, but also across documents on the same or different <span class=""productname"">%productName</span>. For these internal uses, users can copy/cut content, including images and mixed content, on PC by using the keyboard shortcuts directly (<span class=""kbd"">Ctrl</span> + <span class=""kbd"">X</span>, <span class=""kbd"">Ctrl</span> + <span class=""kbd"">C</span>, <span class=""kbd"">Ctrl</span> + <span class=""kbd"">V</span>). For security reasons it is necessary to use <span class=""kbd"">Ctrl</span> + <span class=""kbd"">V</span> to paste on PC, but context menus can be used for cut and copy. On Android or iOS selecting text by double tapping, and using a long-tap to access copy/cut/paste via the context menu is required."	
"To copy larger pieces of content to other applications on your device, users need to press the <span class=""ui"">Start download</span> button, and then re-copy this to their clipboard in order to make it available to the target application to read. This is possible via a tiny widget that pops up in the bottom-right corner, and is only necessary to export the content for pasting in external applications. This step also converts complex object types into static images."	
Document repair	
When multiple people edit the same document concurrently, it is possible for their changes to conflict and this can cause some confusion. The Document Repair function allows users to undo other editor’s changes to the document to a previous state.	
"To jump back to the selected state, select it with the mouse and hit <span class=""ui"">Jump to state</span>."	
"This is particularly useful – say when a colleague inadvertently selected all text in the document with <span class=""kbd"">Ctrl</span> + <span class=""kbd"">A</span> and proceeded to type over it destroying it – while you were concurrently editing."	
Inactive document	
"When <span class=""productname"">%productName</span> detects that there has not been any activity in the browser for a while, it puts the document in an “Inactive” state. The document is shown with a transparent gray overlay, with the message “Inactive document – please click to resume editing”."	
To continue editing, click on the document and the layover and message disappear. Any changes that may have been made by other users – while collaboratively editing the document – are re-loaded.	
Pasting	
When you paste content copied from within the same document, the format and elements are maintained. If you copy from another document, in another tab or browser window, of from outside of the browser, the pasted content will preserve rich text.	
"You can paste as unformatted text with the keyboard shortcut: <span class=""kbd"">Ctrl</span> + <span class=""kbd"">Alt</span> + <span class=""kbd"">Shift</span> + <span class=""kbd"">V</span>"	
When you paste text from within the document, formatting will be respected. You can also paste objects, such as images, if they are copied from the document you are working in.	
When you paste text from outside of the document (another browser window or a desktop application, it will be pasted as rich text.	
When you have internal cut or copied content, you can paste this content with the right mouse button menu.	
Adding charts	
"<span class=""productname"">%productName</span> supports inserting and visualization of charts in documents. To add a chart:"	
Select a table in text document, a range in a spreadsheet or a table in a presentation.	
"Choose <span class=""ui"">Insert</span> → <span class=""ui"">Charts</span>. Customize your chart on the sidebar:"	
If no table or range was selected, a prototype chart is displayed.	
"<span class=""def"">Chart editing:</span> Double click the chart to select. Use context menus to add chart elements such as title, axis, and other. Choose <span class=""ui"">Data Range</span> and <span class=""ui"">Chart Type</span> to edit chart data and select chart type."	
"<span class=""def"">Chart formatting:</span> The same context menu brings you to chart data table and chart type selection."	
"<span class=""def"">Data series formatting:</span> Open the context menu and choose <span class=""ui"">Format data series</span>."	
Handling images	
"<span class=""productname"">%productName</span> inserts images in the text document from your local computer or from your cloud storage. Inserted images are always embedded in the document."	
"<span class=""def"">Insert image:</span> Clicking on the <span class=""ui"">Insert image</span> icon allows you to choose an image from the cloud storage's folders and shares."	
"<span class=""def"">Insert local image:</span> opens the browser file picker to upload the image from your local computer and insert it into the document."	
Images can be resized, rotated and anchored. Text can be wrapped around the image. Select the image and open the context menu. Use the images handles to resize the image with the mouse.	
Comments in documents	Přejít na konec dokumentu
"Insert comments in <span class=""productname"">%productName</span> in places that need special reader attention. Comments are displayed on the right and carry the name and date of the issuer."	
"Click on the submenu (<img style=""height:0.6cm;width:0.6cm;"" alt="""" src=""images/submenu.svg"">) icon to reply, move and delete comments."	
Spellchecking	
"<span class=""productname"">%productName</span> can check spelling in text documents, spreadsheets and presentations. A red wavy underline indicates misspelled words. Click on the right mouse button to open a context menu with suggested misspelling corrections."	
"To systematically spell-check the whole document use the <span class=""ui"">Tools</span> menu’s <span class=""ui"">Spelling</span> option."	
"You edit an online spreadsheet in the same way you edit a desktop spreadsheet. Operations like entering data, selecting ranges, columns, rows or sheets are the same. Use the keyboard, menus or toolbar to command actions in the spreadsheet. Dragging cells contents to fill cells with data is also supported. Copy, cut and paste commands are available from the context menu. Following entered data with a <span class=""kbd"">Tab</span> will move the cursor to the next cell to the right, and with an <span class=""kbd"">Enter</span> to the cell below for easy further data entry."	
Formulas are entered in the formula bar. Enter '=' and insert the formula.	
All spreadsheets functions and mathematical rules applies.	
"The formula language should be extremely familiar to any spreadsheet user, and is specified in great detail in the <a href=""https://www.oasis-open.org/committees/download.php/16826/openformula-spec-20060221.html"">OASIS OpenFormula specification</a>."	
"<span class=""def"">Direct formatting:</span> You can format spreadsheets cells, columns, rows and sheets by formatting directly from the menus, toolbar or context menus. Direct formatting applies only to the current object selected. To format a cell either use the menu or hit <span class=""kbd"">Ctrl</span> + <span class=""kbd"">1</span>. The dialog allows complex and custom number formatting, as well as font, complex border, background, cell protection and other options."	
"<span class=""def"">Sorting data:</span> You can sort a list of numbers or text ascending or descending. <span class=""productname"">%productName</span> automatically detects cells that are headers, and adjoining columns, to extend the selection."	
"<span class=""def"">Filtering data:</span> Filters and advanced filters allow you to work on certain filtered rows (records) of a data range. In the spreadsheets in <span class=""productname"">%productName</span> there are various possibilities for applying filters."	
"One use for the <span class=""ui"">AutoFilter</span> function is to quickly restrict the display to records with identical entries in a data field."	
"In the <span class=""ui"">Standard Filter</span> dialog, you can also define ranges which contain the values in particular data fields. You can use the standard filter to connect the conditions with either a logical AND or a logical OR operator."	
"The <span class=""ui"">Advanced Filter</span> allows up to a total of eight filter conditions. With advanced filters you enter the conditions directly into the sheet."	
"<span class=""def"">Outlining:</span> You can create an outline of your data and group rows and columns together so that you can collapse and expand the groups with a single click making it easy to represent hierarchical data."	
"<span class=""def"">Data validation:</span> For each cell, you can define entries to be valid. Invalid entries to a cell will be rejected. To enable data validation:"	
"Choose <span class=""ui"">Validity</span> from the <span class=""ui"">Data</span> menu. The <span class=""ui"">Validity</span> dialog opens."	
"Select the validity criterion in the <span class=""ui"">Allow</span> drop-box list. Depending on the criterion, more options shows. Fill the required data."	
"Use the <span class=""ui"">Input Help</span> and <span class=""ui"">Error Alert</span> tabs to enhance the user interactions. Click <span class=""ui"">OK</span> to close the dialog."	
"To remove the validity of the cell, open the dialog and set the <span class=""ui"">Allow</span> list to “All values”."	
"<span class=""def"">Comments:</span> In a spreadsheet you can insert one comment per cell. When you select <span class=""ui"">Insert comment</span>, a popup appears that allows you to write the content for the comment. A red dot shows on the top right corner of the cell when it has a comment. Hover the mouse on the cell to display comments."	
"<span class=""def"">Conditional formatting:</span> <span class=""productname"">%productName</span> adds symbols to each cell of a range based on cells conditions. Select the cell range and click the <span class=""ui"">Conditional Formatting</span> icon on the toolbar. Select the symbol set to apply on the range."	
"<span class=""productname"">%productName</span> edits text documents in the same way you edit a desktop document. It provides a What You See Is What You Get (WYSIWYG) layout – that conveniently lays out the document as it will be printed. Operations like typing text, cut, copy and pasting contents, selecting text, inserting, resizing, anchoring images, adding and handling tables and charts, are similar to a desktop word processor. Use the keyboard, menus and toolbars to interact with your document."	
Context menus are available on clicking the right mouse button. The commands available in the context menu are related - not extensively - to the underlying object in the document.	
Formatting text	Formátování textu
"<span class=""productname"">%productName</span> supports modern techniques for paragraph formatting through styles. A style is a set of text properties (font, color, background and many more) labeled with a name, the style name. Use style to apply the same set of properties to many paragraphs in the document and produce a uniform, professional look. Also, if you change one of the style formatting properties, all paragraphs with the same style changes formatting as well, simplifying the effort of formatting many paragraph individually."	
In contrast, direct formatting applies formatting to selected excerpts of the document contents. On a long document, direct formatting must be applied in every text excerpt, turning text formatting a long task, subject to errors and delays.	
"<span class=""def"">Direct formatting:</span> You can format text document objects by formatting directly from the menus, toolbar or context menus. Direct formatting applies only to the current object selected."	
"<span class=""def"">Style formatting:</span> <span class=""productname"">%productName</span> support paragraph styles. You can apply an existing paragraph style to a paragraph. Choose menu <span class=""ui"">Edit</span> → <span class=""ui"">Edit styles</span> to change style."	
Handling Tables	
"Insert tables with proper icon in the toolbar. Select the initial number of rows and columns. Add rows and columns with the cell context menu. Merge cells with the <span class=""ui"">Table</span> menu. The default paragraph style inside cells is “Table contents”."	
"<span class=""def"">Formatting cells:</span> Click in the cell or range of cells and choose menu <span class=""ui"">Table</span> → <span class=""ui"">Properties</span>. Fine tune the table with the properties dialog."	
Track changes	
"When you turn on Track Changes, <span class=""productname"">%productName</span> marks up new changes made to the document. Select this option again to turn it off."	
Changes made by different people are shown in different colors and each tracked change can be accepted or rejected, using the box the appears on the right. You can also add a comment there.	
Other advanced features	
"<span class=""def"">Comments:</span> Comments are inserted in the text and displayed on the right side of the screen."	
"<span class=""def"">Formatting marks:</span> Paragraph, page and unbreakable spaces are shown as marks to assisting text alignment, editing and formatting."	
"<span class=""def"">Fields:</span> A basic set of fields is available to insert in the document."	
"<span class=""def"">Alphabetical index:</span> Existing alphabetical index can be updated with new entries."	
"<span class=""def"">Page header and footer:</span> Headers and footers are available for the existing page style applied in the document at the cursor position."	
"<span class=""def"">Footnotes and endnotes:</span> Footnotes and endnotes are supported, being rendered as they are shown."	
"<span class=""productname"">%productName</span> Impress edits presentations in a way that should be familiar to people. Operations like typing text, cut, copy and pasting contents, selecting text , inserting, resizing, anchoring images, adding and handling tables, are similar to a desktop presentation application. Use the keyboard, menus and toolbars to perform actions in your document."	
"<span class=""productname"">%productName</span> displays presentation slide shows, including a subset of slide transitions and object animations. Choose the slide show from the menu or click on icon in the bottom left toolbar in the slide pane."	
"To exit a <span class=""productname"">%productName</span> slide show, press the <span class=""kbd"">Esc</span> key to return to the presentation edit mode."	
Click on any slide thumbnail in the pane to switch to this slide to view or edit it.	
Use the slide pane toolbar in the bottom to start the slideshow, add slide, duplicate or delete the current slide.	
"<span class=""def"">Slide layouts:</span> <span class=""productname"">%productName</span> Impress let you change the slide layout. Select the desired slide layout in the drop-down layout list."	
"<span class=""def"">Master slide:</span> Select the master slide associated to the current slide. Format and arrange slide elements in the master slide."	
"<span class=""def"">Slide transitions:</span> <span class=""productname"">%productName</span> Impress provides visual effects when displaying a new slide in the slide show. Slide transitions are property of the slide, use the side bar to set the slide transition when in edit mode."	
"<span class=""def"">Object animation:</span> Individual object in the slide can have animation. Use the side bar to configure the slide transition for a selected object or set of objects."	
"<span class=""def"">Tables:</span> Insert tables in the presentation. Use the sidebar to select the table theme."	
"What are the documents file formats supported by <span class=""productname"">%productName</span>?"	
"<span class=""productname"">%productName</span> supports both reading and writing for the following file formats:"	
Text documents: Microsoft formats DOC, DOCX, RTF. OpenDocument Format ODT	
Spreadsheets: Microsoft formats XLS, XLSX, OpenDocument Format ODS	
Presentations: Microsoft formats PPT, PPTX, OpenDocument Format ODP	
In addition it can provide viewing for Visio, Keynote, Numbers, and Pages formats.	
How do I save a document with another name?	
Hover the mouse on the document name in the menu bar.	
"Type the new file name in the text box and press <span class=""kbd"">Enter</span>."	
A copy of the document is saved with the new name in the same folder.	
"How can I quit <span class=""productname"">%productName</span> without saving my edits?"	
"<span class=""productname"">%productName</span> saves the document in the background regularly, you can't just close without saving it. To abandon your changes, you must either undo them, or use the <span class=""ui"">Revision History </span> in the <span class=""ui"">File</span> menu."	
"Can <span class=""productname"">%productName</span> open a password-protected document?"	
"Yes. <span class=""productname"">%productName</span> opens password-protected documents, but it is necessary to supply the password in the “Enter password” prompt at load time."	
How can I check spelling in my language?	
"Choose menu <span class=""ui"">Tools</span> → <span class=""ui"">Languages</span> and select the language for the whole document. Optionally you can set languages for the selected text and for the current paragraph."	
How can I remove the red wavy lines in my document?	
"Choose menu <span class=""ui"">Tools</span> and uncheck <span class=""ui"">Automatic Spell Checking</span>."	
What is the blue wavy underline in some words in the text?	
Grammar errors in the text is marked with the blue wavy underline. Click on the underlined text with the right mouse button to open a menu with suggestions to correct the grammar error and the offending grammar rules. Select the right suggestion to change the text.	
Is here a thesaurus?	
"Yes. Click in the word you want and choose <span class=""ui"">Tools</span> → <span class=""ui"">Thesaurus</span>. A dialog opens with many suggestions for replacements."	
"What are the blue <span class=""blue"">¶</span> symbol and how can I remove from my text document?"	
"The <span class=""blue"">¶</span> symbol is a formatting mark. It is used to help text alignment and editing and is not printed. To toggle it in the document display, choose menu <span class=""ui"">View</span> → <span class=""ui"">Formatting mark</span>."	
How do I get a word count of my document?	Přejít na začátek dokumentu
"Word count is available in <span class=""ui"">Tools</span> → <span class=""ui"">Word count</span>. A dialog shows word counts for selection and for the whole document."	
Word count is also displayed in the status bar. If no text is selected the word count is for the whole document. Otherwise the word count is for the selected text.	
How can I insert a currency, copyright or trademark symbol in the document?	
"You can insert these special characters in the document using the <span class=""ui"">Special Character</span> dialog."	
Place the cursor in the position to insert the character.	
"Choose <span class=""ui"">Insert</span> → <span class=""ui"">Special Characters </span> or click the corresponding icon in the toolbar. A dialog shows."	
"You can either browse the characters displayed with the drop lists or type a search key in the <span class=""ui"">Search</span> box. If you know the Unicode numeric code of the special character, enter in the boxes on the right."	
"Press <span class=""ui"">Insert</span> button. To close the dialog, press <span class=""ui"">Cancel</span>."	
Why can't I delete text? It just gets a strike-through?	
"You have the Track Changes feature enabled for the document. Track Changes records all changes in the text and shows the editions for later revision. Useful for marking changes in text and spreadsheets. Track changes are enabled choosing <span class=""ui"">Edit</span> → <span class=""ui"">Track Changes </span> → <span class=""ui"">Record</span>."	
With track changes enabled your document show the following settings:	
Deletions are marked with colored strike-through characters.	
Additions are marked with colored underlined characters.	
All changes are marked with a vertical bar in the right margin.	
Changes are displayed as comment in the right of the document area.	
The color assigned to the changes depends on the user that changes the document.	
"To display or hide track changes choose <span class=""ui"">Edit</span> → <span class=""ui"">Track Changes </span> → <span class=""ui"">Show</span>. Beware that if track changes are enabled but hidden, you still record changes and may inadvertently leave unwanted text available in the document."	
"Changes can be accepted or rejected. To accept or reject changes, click on the corresponding icons in the comment box on the right of the document. Alternatively, choose <span class=""ui"">Edit</span> → <span class=""ui"">Track Changes </span> → <span class=""ui"">Accept</span> or <span class=""ui"">Reject</span>. Furthermore, if you need to filter changes before accepting or rejecting, choose <span class=""ui"">Edit</span> → <span class=""ui"">Track Changes </span> → <span class=""ui"">Manage</span>. A dialog shows a list of all tracked changes. Use the dialog buttons accordingly."	
How do I set the margins of the document?	Přejít na začátek dokumentu
Using the ruler drag the leftmost edge of the ruler to adjust the left margin, or the rightmost for the right margin.	
Using the page style	
"Choose <span class=""ui"">Format</span> → <span class=""ui"">Page</span> and select the <span class=""ui"">Page</span> tab"	
Set the page margins in the dialog.	
How do I change the page orientation to landscape inside my document	
Place the cursor at the place where the page orientation is to change. Add an empty paragraph.	
"Choose <span class=""ui"">Format</span> → <span class=""ui"">Paragraph</span>, <span class=""ui"">Text Flow </span> tab"	
"In the <span class=""ui"">Breaks</span> area, mark Insert, Type: Page Break, Position: Before."	
Select Landscape in “With Page Style”	
Select if you want to change page numbering.	
To return to portrait orientation, repeat the procedure, choosing Portrait in “With page style”.	
How can I make the new text look like other existing text?	
Directly:	
Select the text with the existing format	
"Click on the clone formatting icon <img style=""height:0.6cm;width:0.6cm;"" alt="""" src=""images/lcformatpaintbrush.svg"">. The mouse pointer turns to a paint bucket."	
Select the text you want to apply the new format.	
Applying a paragraph style:	Použít styl odstavce Nadpis 1
Place the cursor at the paragraph to be formatted	
Select the style to apply in the style dropdown list. The paragraph displays the styles attributes.	
Why did the text I just typed change automatically? How can I revert it?	
"You have the AutoCorrection enabled. AutoCorrection changes the text just typed into an internal table of corresponding text. In most cases, AutoCorrection fixes typos while you are typing. If AutoCorrection is not necessary, disable it in <span class=""ui"">Tools</span> → <span class=""ui"">AutoCorrection</span> → <span class=""ui"">While typing</span>."	
How can I select data to print?	
Insert column and row breaks in the spreadsheet to narrow the print range and print the document to download. On printing the PDF, select the pages of interest.	
How can I import CSV data?	
Load your CSV data in some native tool to your platform, select and copy it to the clipboard	
"Activate the <span class=""productname"">%productName</span> spreadsheet window."	
"Paste from the browser <span class=""ui"">Edit</span> → <span class=""ui"">Paste</span> or press <span class=""kbd"">Ctrl</span> + <span class=""kbd"">V</span>. The <span class=""ui"">Text Import</span> dialog opens to let you describe the precise format of the CSV data."	
Select the character set, language and separator options for the CSV file.	
The CSV data is loaded into the selected cell where you pasted, according to these settings.	
How can I copy the formatting of existing cells to new ones?	
This is easy to do using the Paintbrush tool in the toolbar.	
Format the source cell with the font, color background and more.	
Select the cells you want to format. Release the mouse button.	
What is “Clear Direct Formatting” icon?	
"Direct formatting is formatting applied directly to the selected contents of a paragraph or a spreadsheet cell, and overlaps its assigned style formatting. To restore the formatting to the style settings, select the text or spreadsheet cell and choose <span class=""ui"">Format</span> → <span class=""ui"">Clear Direct Formatting</span> or use the button in the toolbar."	
How do I rename a sheet?	
Rename a sheet in the spreadsheet document using the context menu (using the right mouse button) over the sheet tab in the bottom. Enter the new sheet name in the dialog that follows.	
How can I run my slide show?	
"Open the presentation in <span class=""productname"">%productName</span>"	
"Either choose <span class=""ui"">Slide Show</span> → <span class=""ui"">Full Screen Presentation</span> or click on the left-most icon in the bottom of the slide panel: <img style=""height:0.6cm;width:0.6cm;"" alt="""" src=""images/lcdia.svg"">"	
How can I change the line, area and position of a shape in my slides?	
Select the shape in your slide. A set of handles shows.	
"Choose <span class=""ui"">Format</span> → <span class=""ui"">Line</span> (or <span class=""ui"">Area</span>, or <span class=""ui"">Position and Size</span>). A dialog opens."	
Set the properties of the element of the object.	
Admin console	Ovládací panel administrátora
Settings	Nastavení
Overview	Přehled
(current)	(aktuální)
Analytics	Analytické údaje
History	Historie
Dashboard	Nástěnka
Users online	Přihlášení uživatelé
User Name	Uživatelské jméno
Documents opened	Otevřené dokumenty
Number of Documents	Počet dokumentů
Memory consumed	Spotřebovaná paměť
Bytes sent	Odeslané bajty
Bytes received	Přijaté bajty
PID	PID
Document	Dokument
Number of views	Počet zobrazení
Elapsed time	Uplynulý čas
Idle time	Doba nečinnosti
Modified	Změněno
Kill	Ukončit
Graphs	Grafy
Memory Graph	Graf paměti
CPU Graph	Graf procesoru
Network Graph	Graf sítě
Save	Uložit
Cache size of memory statistics	Velikost mezipaměti pro statistiku paměti
Time interval of memory statistics (in ms)	Časový interval pro statistiku paměti (v ms)
Cache size of CPU statistics	Velikost mezipaměti pro statistiku procesoru
Time interval of CPU statistics (in ms)	Časový interval statistiky procesoru (v ms)
Maximum Document process virtual memory (in MB) - reduce only	Maximální virtuální paměť procesu dokumentu (v MB) - lze pouze zmenšit
Maximum Document process stack memory (in KB) - reduce only	Maximální paměť procesu dokumentu v zásobníku (v kB) - lze pouze zmenšit
Maximum file size allowed to write to disk (in MB) - reduce only	Maximální velikost souboru pro zápis na disk (v MB) - lze pouze zmenšit
Documents:	Dokumenty:
Expired:	Platnost vypršela:
Refresh	Obnovit
Shutdown Server	Vypnout server
Server uptime	Doba běhu serveru
Received	Přijaté
Sent	Odeslané
Connection error	Chyba spojení
Are you sure you want to terminate this session?	Opravdu si přejete ukončit tuto relaci?
Documents	Dokumenty
Are you sure you want to shut down the server?	Opravdu si přejete tento server vypnout?
kB	kB
MB	MB
GB	GB
TB	TB
 hrs	 hod
 mins	 min
 s	 s
Open link	Otevřít hypertextový odkaz
Edit	Upravit
The server encountered a %0 error while parsing the %1 command.	Server zaznamenal během zpracovávání příkazu %1 chybu %0.
Paste Special	Vložit jinak
Repair Document	Opravit dokument
Type	Typ
Index	Index
Comment	Komentář
User name	Uživatelské jméno
Timestamp	Čas změny
Jump to state	Přejít na stav
You	Vy
Start download	Zahájit stahování
Confirm copy to clipboard	Potvrdit kopírování do schránky
Start upload	Zahájit nahrávání
Start cross copy/paste	Zahájit kopírování/vkládání
No color	Automatická
Linear	
Axial	
Radial	
Elipsoid	
Quadratic	
Square	
Fixed size	
None	Žádná
Color	
Gradient	
Hatching	
Pattern	
From	
To	
Font Name	Písmo
Font Size	Nepodepsáno
Rows	
Columns	
Insert table	Vložit tabulku
None (Do not check spelling)	Žádný (bez kontroly pravopisu)
Cancel	Zrušit
Share...	Sdílet...
See revision history	Zobrazit historii revizí
Download as	Stáhnout jako
PDF Document (.pdf)	Dokument PDF (.pdf)
ODF text document (.odt)	Textový dokument ODF (.odt)
Word 2003 Document (.doc)	Dokument Word 2003 (.doc)
Word Document (.docx)	Dokument Word (.docx)
Rich Text (.rtf)	Rich Text (.rtf)
Sign document	Podepsat dokument
Close document	Zavřít dokument
Repair	Opravit
Reset zoom	Obnovit přiblížení
Show Ruler	Zobrazit pravítko
Local Image...	Místní obrázek...
All	Vše
Text orientation	Orientace textu
Online Help	
Keyboard shortcuts	Klávesové zkratky
About	O aplikaci
Last modification	Poslední změna
ODF presentation (.odp)	Prezentace ODF (.odp)
PowerPoint 2003 Presentation (.ppt)	Prezentace PowerPoint 2003 (.ppt)
PowerPoint Presentation (.pptx)	Prezentace PowerPoint (.pptx)
Fullscreen presentation	Prezentace na celou obrazovku
ODF spreadsheet (.ods)	Sešit ODF (.ods)
Excel 2003 Spreadsheet (.xls)	Sešit Excel 2003 (.xls)
Excel Spreadsheet (.xlsx)	Sešit Excel (.xlsx)
Export as	Exportovat jako
Insert Shape	Vložit tvary
Reset to Default Language	Obnovit výchozí jazyk
Are you sure you want to delete this slide?	Opravdu si přejete smazat tento snímek?
<p>Your browser has very limited access to the clipboard, so use these keyboard shortcuts:<ul><li><b>Ctrl+C</b>: For copying.</li><li><b>Ctrl+X</b>: For cutting.</li><li><b>Ctrl+V</b>: For pasting.</li></ul></p>	<p>Prohlížeč má velmi omezený přístup ke schránce, proto používejte tyto klávesové zkratky:<ul><li><b>Ctrl+C</b>: pro kopírování.</li><li><b>Ctrl+X</b>: pro vyjímání.</li><li><b>Ctrl+V</b>: pro vkládání.</li></ul></p>
Scroll up annotations	Posunout na komentář výše
Scroll down annotations	Posunout na komentář níže
Insert sheet before this	Vložit list před tento
Insert sheet after this	Vložit list za tento
Are you sure you want to delete sheet, %sheet% ?	Opravdu si přejete smazat list, %sheet% ?
Enter new sheet name	Zadejte nový název listu
Are you sure you want to delete this page?	Opravdu si přejete smazat tuto stránku?
Default Style	
Borders	Ohraničení
More...	Více...
Insert Local Image	Vložit místní obrázek
Insert shapes	Vložit tvary
First sheet	První list
Previous sheet	Předchozí list
Next sheet	Následující list
Last sheet	Poslední list
Insert sheet	Vložit list
Search	Hledat:
Cancel the search	Zrušit vyhledávání
Always follow the editor	Vždy následovat tohoto editora
Current	Aktuální
%user has joined	%user se připojil
%user has left	%user se odpojil
Number of Sheets	Počet listů
Selected range of cells	Vybraná oblast buněk
Entering text mode	Přepínání do textového režimu
Selection Mode	Režim výběru
Choice of functions	Volba funkcí
Average	Průměr
CountA	Počet hodnot
Count	Počet čísel
Maximum	Maximum
Minimum	Minimum
Sum	Součet
Selection count	Počet vybraných
Number of Pages	Počet stránek
Word Counter	Počet slov
Number of Slides	Počet snímků
%n users	%n uživatelů
1 user	1 uživatel
0 users	Žádný uživatel
Style	Styl
Font	Písmo
Previous slide	Předchozí snímek
Next slide	Následující snímek
Conflict Undo/Redo with multiple users. Please use document repair to resolve	Konflikt použití Zpět/Znovu s více uživateli. Pro vyřešení prosím použijte opravu dokumentu
Readonly	Pouze pro čtení
Left Margin	Levý okraj
Right Margin	Pravý okraj
Please enter the PIN Code	Zadejte prosím PIN kód
Error at login.	Chyba při přihlášení.
Please scan the code	Prosím naskenujte kód
Couldn't get the QR code image.	Nelze získat obrázek QR kódu.
Error when trying to restore access to identity.	Při pokusu o obnovení přístupu k identitě došlo k chybě.
PIN Code	PIN kód
Please enter the PIN code from the EMail or SMS	Zadejte kód PIN z e-mailu nebo SMS
Login from email or mobile number	Přihlaste se z e-mailu nebo mobilního čísla
Select document type to upload	Vyberte typ dokumentu, který chcete nahrát
Type:	Typ:
Document uploaded.	Dokument nahrán.
Select identity:	Vyberte identitu:
Login from mobile	Přihlášení z mobilu
Recover from email	Obnova z e-mailu
Select passport	Vybrat průkaz
Passport: N/A	Průkaz: N/A
Sign	Podepsat
Status:	Stav:
	
Login	Přihlášení
Close	Zavřít
Not Signed	Nepodepsáno
This document is digitally signed and the signature is valid.	Tento dokument je elektronicky podepsán platným podpisem.
Signed and validated	Podepsáno a validováno
This document has an invalid signature.	Tento dokument má neplatný podpis.
Signature broken	Podpis poškozen
The signature was valid, but the document has been modified	Podpis byl platný, ale dokument se změnil
Signed but document modified	Podepsáno, ale dokument byl změněn
The signature is OK, but the certificate could not be validated.	Podpis je v pořádku, ale certifikát nelze ověřit.
Signed but not validated	Podepsán, ale není validován
The signature is OK, but the document is only partially signed	Podpis je v pořádku, ale dokument je podepsán pouze částečně
Signed but not all files are signed	Podepsáno, ale ne všechny soubory jsou podepsány
Downloading...	Stahování...
Saving...	Ukládání...
Renaming...	Přejmenovávání...
This version of %productName is powered by	Tato verze aplikace %productName využívá
Insert hyperlink	Vložit hypertextový odkaz
Text	Text
Link	Odkaz
OK	OK
IE11 has reached its maximum number of connections. Please see this document to increase this limit if needed: https://docs.microsoft.com/en-us/previous-versions/windows/internet-explorer/ie-developer/general-info/ee330736(v=vs.85)#websocket-maximum-server-connections	Prohlížeč IE11 dosáhl maximálního počtu připojení. V případě potřeby můžete tento limit navýšit podle následujícího dokumentu: https://docs.microsoft.com/en-us/previous-versions/windows/internet-explorer/ie-developer/general-info/ee330736(v=vs.85)#websocket-maximum-server-connections
Oops, there is a problem connecting to LibreOffice Online : 	Jejda, nastal problém s přípojením k LibreOffice Online: 
Served by:	
Unsupported server version.	Nepodporovaná verze serveru.
Session terminated by document owner	Relace byla ukončena vlastníkem dokumentu
Idle document - please click to reload and resume editing	Neaktivní dokument - kliknutím jej znovu načtete a budete moci pokračovat v úpravách
Server is shutting down for maintenance (auto-saving)	Server bude vypnut z důvodu údržby (automatické ukládání)
Oops, there is a problem connecting the document	Došlo k problému při připojování k dokumentu
Server is recycling and will be available shortly	Server je obnovován a bude brzy dostupný
Document has changed in storage. Loading the new document. Your version is available as revision.	Dokument byl v úložišti změněn. Načítá se nová verze, vaše verze bude dostupná jako revize.
Restoring older revision. Any unsaved changes will be available in version history	Obnovuje se starší revize. Veškeré neuložené změny budou dostupné v historii verzí.
Document has been changed in storage. What would you like to do with your unsaved changes?	Dokument byl v úložišti změněn. Co si přejete provést se svými neuloženými změnami?
Discard	Zahodit
Overwrite	Přepsat
Save to new file	Uložit do nového souboru
Document requires password to view.	Pro prohlížení dokumentu je vyžadováno heslo.
Document requires password to modify.	Pro úpravy dokumentu je vyžadováno heslo.
Hit Cancel to open in view-only mode.	Stisknutím Zrušit dokument otevřete v režimu jen pro čtení.
Wrong password provided. Please try again.	Chybné heslo. Zkuste ho zadat znovu.
Connecting...	Připojování...
Well, this is embarrassing, we cannot connect to your document. Please try again.	Toto je nepříjemné, nemůžeme se připojit k dokumentu. Zkuste to znovu.
No disk space left on server, please contact the server administrator to continue.	Nedostatek volného místa na serveru, pro pokračování se prosím obraťte na správce serveru.
The host URL is empty. The loolwsd server is probably misconfigured, please contact the administrator.	Hostitelská URL je prázdná. Loolwsd server je pravděpodobně nesprávně nakonfigurován, obraťte se prosím na správce.
This is an unsupported version of {productname}. To avoid the impression that it is suitable for deployment in enterprises, this message appears when more than {docs} documents or {connections} connections are in use concurrently	Toto je nepodporovaná verze {productname}. Protože není vhodná pro nasazení v podnikovém prostředí, zobrazuje se tato zpráva v případě, že je současně použito {docs} dokumentů nebo {connections} připojení.
More information and support	Další informace a podpora
This service is limited to %0 documents, and %1 connections total by the admin. This limit has been reached. Please try again later.	Tato služba je administrátorem omezena na %0 dokumentů a %1 spojení. Toto omezení bylo dosaženo. Zkuste to prosím znovu později.
Service is unavailable. Please try again later and report to your administrator if the issue persists.	Služba není dostupná. Prosím zkuste to později a v případě setrvání problému konktaktujte svého správce.
Unauthorized WOPI host. Please try again later and report to your administrator if the issue persists.	Neoprávněný WOPI hostitel. Zkuste to prosím později a v případě setrvání problému kontaktujte svého správce.
Wrong or missing WOPISrc parameter, please contact support.	Chybný nebo chybějící parametr WOPISrc, kontaktujte podporu.
Your session will expire in %time. Please save your work and refresh the session (or webpage) to continue.	Relace vyprší v %time. Pro pokračování prosím uložte Vaši práci a obnovte relaci (nebo webovou stránku).
Your session has been expired. Further changes to document might not be saved. Please refresh the session (or webpage) to continue.	Vaše relace vypršela. Další změny dokumentu nemusí být uloženy. Pro pokračování prosím obnovte relaci (nebo webovou stránku).
Failed to load the document. Please ensure the file type is supported and not corrupted, and try again.	Nepodařilo se načíst dokument. Ujistěte se prosím, že je tento typ souboru podporován a soubor není poškozen a zkuste to znovu.
Invalid link: '%url'	Neplatný odkaz: '%url'
You are leaving the editor, are you sure you want to visit %url?	Opouštíte editor, opravdu chcete navštívit %url?
Failed to load the document. This document is either malformed or is taking more resources than allowed. Please contact the administrator.	
Failed to load document.	Nepodařilo se načíst dokument.
Save failed due to no disk space left. Document will now be read-only.	Kvůli nedostatku místa na disku se dokument nepodařilo uložit. Dokument se zobrazí v režimu pouze pro čtení.
Document cannot be saved due to expired or invalid access token.	Dokument nelze uložit. Přístupový token vypršel nebo není platný.
Document cannot be saved.	Dokument nelze uložit.
Document cannot be renamed.	Dokument nelze přejmenovat.
Failed to read document from storage. Please contact your storage server (%storageserver) administrator.	Nepodařilo se načíst dokument. Prosím kontaktujte správce vašeho síťového úložiště (%storageserver).
Save failed due to no disk space left on storage server. Document will now be read-only. Please contact the server (%storageserver) administrator to continue editing.	Z důvodu nedostatku volného místa na serveru se nepodařilo dokument uložit. Dokument je nyní pouze pro čtení. Chcete-li pokračovat v úpravách, kontaktujte prosím správce síťového úložiště (%storageserver).
Document cannot be saved. Check your permissions or contact the storage server administrator.	Dokument nelze uložit. Ujistěte se, zda máte dostatečná oprávnění, nebo se obraťte na správce serveru.
Document cannot be renamed. Check your permissions or contact the storage server administrator.	Dokument nelze přejmenovat. Ujistěte se, zda máte dostatečná oprávnění, nebo se obraťte na správce serveru.
Uploading file to server failed, file not found.	
Uploading file to server failed, the file is too large.	
Accept change	Přijmout změnu
Reject change	Odmítnout změnu
Open menu	Otevřít nabídku
Reply	Odpověď
Show the search bar	Zrušit vyhledávání
Clear the search field	Zrušit vyhledávání
Hide the search bar	Zrušit vyhledávání
Modify	Změnit
Remove	Odstranit
Resolve	Vyřešit
To paste outside %productName, please first click the 'download' button	Při vkládání mimo %productName nejprve klikněte na tlačítko Stáhnout
Failed to download clipboard, please re-copy	Nepodařilo se stáhnout schránku, zkuste zkopírovat znovu
<p>Please use the copy/paste buttons on your on-screen keyboard.</p>	<p>Použijte tlačítka kopírovat/vložit na klávesnici na obrazovce.</p>
"<p>If you would like to share larger elements of your document with other applications it is necessary to first download them onto your device. To do that press the ""Start download"" button below, and when complete click ""Confirm copy to clipboard"".</p><p>If you are copy and pasting between documents inside %productName, there is no need to download.</p>"	<p>Pokud si přejete sdílet větší prvky dokumentu s jinou aplikací, je nezbytné je napřed stáhnout na vaše zařízení. K tomu slouží níže zobrazené tlačítko „Zahájit stahování“, po skončení klikněte na „Potvrdit kopírování do schránky“.</p><p>Jestliže kopírujete a vkládáte mezi dokumenty v rámci %productName, nic stahovat nepotřebujete.</p>
<p>A download due to a large copy/paste operation has already started. Please, wait for the current download or cancel it before starting a new one</p>	<p>Stahování za účelem rozsáhlého kopírování/vkládání již začalo. Počkejte na jeho dokončení, nebo ho před zahájením nového nejprve zrušte.</p>
Initializing...	Inicializace...
%d seconds ago	před %d sekundami
%d minutes ago	před %d minutami
Inactive document - please click to resume editing	Dokument je neaktivní - pro pokračování v úpravách klikněte
Loading...	Načítání...
The file of type: %0 can not be uploaded to server since the file has no name	
The file of type: %0 can not be uploaded to server since the file is empty	
Uploading...	Nahrávání...
Uploading file to server failed with status: %0	
Creating new file from template...	Vytváří se nový soubor ze šablony ...
Creating copy...	Vytváření kopie...
Mobile Wizard	Mobilní průvodce
Function	Funkce
Accept	Přijmout

